com/daimajia/easing/BuildConfig = Com.Daimajia.Easing.BuildConfig
  <init>()V = .ctor()
  BUILD_TYPE = BuildType
  DEBUG = Debug
  LIBRARY_PACKAGE_NAME = LibraryPackageName
  VERSION_CODE = VersionCode
  VERSION_NAME = VersionName
com/daimajia/easing/Glider = Com.Daimajia.Easing.Glider
  <init>()V = .ctor()
  glide(Lcom/daimajia/easing/Skill;FLandroid/animation/PropertyValuesHolder;)Landroid/animation/PropertyValuesHolder; = Glide(Com.Daimajia.Easing.Skill, float, Android.Animation.PropertyValuesHolder)
  glide(Lcom/daimajia/easing/Skill;FLandroid/animation/ValueAnimator;)Landroid/animation/ValueAnimator; = Glide(Com.Daimajia.Easing.Skill, float, Android.Animation.ValueAnimator)
com/daimajia/easing/Skill = Com.Daimajia.Easing.Skill
  BackEaseIn = BackEaseIn
  BackEaseInOut = BackEaseInOut
  BackEaseOut = BackEaseOut
  BounceEaseIn = BounceEaseIn
  BounceEaseInOut = BounceEaseInOut
  BounceEaseOut = BounceEaseOut
  CircEaseIn = CircEaseIn
  CircEaseInOut = CircEaseInOut
  CircEaseOut = CircEaseOut
  CubicEaseIn = CubicEaseIn
  CubicEaseInOut = CubicEaseInOut
  CubicEaseOut = CubicEaseOut
  ElasticEaseIn = ElasticEaseIn
  ElasticEaseOut = ElasticEaseOut
  ExpoEaseIn = ExpoEaseIn
  ExpoEaseInOut = ExpoEaseInOut
  ExpoEaseOut = ExpoEaseOut
  Linear = Linear
  QuadEaseIn = QuadEaseIn
  QuadEaseInOut = QuadEaseInOut
  QuadEaseOut = QuadEaseOut
  QuintEaseIn = QuintEaseIn
  QuintEaseInOut = QuintEaseInOut
  QuintEaseOut = QuintEaseOut
  SineEaseIn = SineEaseIn
  SineEaseInOut = SineEaseInOut
  SineEaseOut = SineEaseOut
  valueOf(Ljava/lang/String;)Lcom/daimajia/easing/Skill; = ValueOf(string)
  values()[Lcom/daimajia/easing/Skill; = Values()
